NO /home/cgaratej/42/cub3d/assets/img_no.xpm
SO /home/cgaratej/42/cub3d/assets/img_so.xpm
WE /home/cgaratej/42/cub3d/assets/img_we.xpm
EA /home/cgaratej/42/cub3d/assets/img_ea.xpm

F 139,69,19
C 135,206,235

11111111
10001001
10001001
10000101
10010011
11010111
1E000001
11111111