NO assets/img/barrel.xpm42
SO assets/img/eagle.xpm42
WE assets/img/barrel.xpm42
EA assets/img/bluestone.xpm42

F 220,100,0
C 225,30,0

        1111111111111111111111111
        1000000000110000000000001   1
        1011000001110000000000001  101
        1001000000000000000000001   1
111111111011000001110000000000001
10000000001100000111011111D111111
11110111111111011100000010001
11110111111111001110101010001
11000000110101011100000010001
10000000001000001100000010001
10000000000100000001010010001
11000001110101011111011110N01
11110111 1110101 1 1111 10001
11111111 1111111 111111111111