NO assets/img/barrel.xpm42
SO assets/img/eagle.xpm42
WE assets/img/colorstone.xpm42
EA assets/img/bluestone.xpm42

F 139,69,19
C 135,206,235


1111111111111
1000000000001
1001111111001
1001     1001
100111D111001
1E00000000001
1111111111111