NO assets/img/barrel.xpm42
SO assets/img/eagle.xpm42
WE assets/img/barrel.xpm42
EA assets/img/bluestone.xpm42

F 139,69,19
C 135,206,235

    11111111
    10001001
    10000001
111110000111
100001001
100100001
110101101
1E0000001
111111111