NO assets/img/barrel.xpm42
SO assets/img/eagle.xpm42
WE assets/img/colorstone.xpm42
EA assets/img/bluestone.xpm42

F 139,69,19
C 135,206,235

11111111111111111111111111111111111111111111111111111111111111111111111111111111
10000000000000000000000000000000000000000000000000000000000000000000000000000001
10000000000000000000000000000000000000100000000000000000000000000000000000000001
10000000000000000000000000000000000000100000000000000000000000000000000000000001
10000000000001000000000000000000000000100000000000000000000000000000000000000001
100000000E000D000000000000000000000000100000000000000000000000000000000000000001
10000000000001000000000000000000000000100000000000000000000000000000000000000001
10000000000000000000000000000000000000100000000000000000000000000000000000000001
10000000000000000000000000000000000000100000000000000000000000000000000000000001
11111111111111111111111111111111111111111111111111111111111111111111111111111111